4,3,3,3,3,3,3,3,3,3,3,3,5
3,2,0,A,A,A,1,A,1,A,0,2,3
3,0,A,1,1,1,1,A,1,1,1,0,3
3,1,1,1,1,1,1,1,1,A,1,1,3
3,1,1,1,1,1,1,1,1,1,A,1,3
3,1,1,1,1,1,1,A,1,A,1,1,3
3,1,1,1,A,A,1,1,1,1,A,A,3
3,1,1,A,1,1,1,1,1,1,1,1,3
3,A,A,1,1,1,1,1,1,1,A,1,3
3,A,A,A,A,1,1,1,A,1,1,A,3
3,0,1,1,1,1,A,A,1,A,1,0,3
3,2,0,1,A,1,1,A,1,1,0,2,3
6,3,3,3,3,3,3,3,3,3,3,3,7
